0,0,0,0,4
0,0,0,0,2
4,1,2,2,2
0,0,0,0,2
0,0,0,0,2
0,0,0,0,2
0,0,0,0,3