4,2,2,2,2,2,2
0,2,2,0,0,2,2
0,2,2,0,2,2,4
0,2,1,2,0,2,2
0,2,4,2,2,2,3