2,2,2,2,2
3,0,0,4,2
0,2,2,2,2
2,2,2,2,2
1,2,2,2,2